14;14
              
  # #  # ###  
  # #  #  #   
  # #  #  #   
  #  ##   #   
              
   ##    ##   
  #  #  #  #  
     #  #     
     #  ###   
    #   ####  
   #    ####  
  ####   ##   
              
